densità	n	8	density
undef	n	7	
più	r	6	more
termale	a	5	thermal
undef	v	5	
formarsi	v	4	form
trattarsi	v	4	
ingiusto	a	3	unfair
volgere	v	3	turn
così	r	3	so
più	r	3	most
perso	a	3	lost
stazione_di_servizio	n	3	garage
svuotare	v	3	empty
fioco	a	3	dim
cerebrale	a	3	cerebral
record_mondiale	n	2	world_record
risvegliare	v	2	wake_up
volgare	a	2	vulgar
voluttuoso	a	2	voluptuous
visuale	a	2	visual
vittimizzare	v	2	victimize
vibrante	a	2	vibrant
Utah	n	2	utah
intatto	a	2	untouched
impreparato	a	2	unprepared
impassibile	a	2	unmoved
unanime	a	2	unanimous
trionfante	a	2	triumphant
triplo	n	2	triple
allenato	a	2	trained
Texas	n	2	texas
tecnicamente	r	2	technically
presunto	a	2	supposed
sottendere	v	2	subtend
risvegliare	v	2	stir
aderire	v	2	stick_to
organico	n	2	staff
struttura_sociale	n	2	social_structure
liscio	a	2	smooth
esiguo	a	2	small
sedicesimo	a	2	sixteenth
laterale	a	2	side
sic	r	2	sic
settimo	a	2	seventh
serratus	n	2	serratus
scolastico	a	2	scholastic
derubare	v	2	rob
righthander	n	2	right-hander
reversibile	a	2	reversible
restituire	v	2	repay
reliquia	n	2	relic
registrato	a	2	recorded
rassicurare	v	2	reassure
giungere	v	2	reach
razionalizzare	v	2	rationalize
viola	a	2	purple
possibilità 	n	2	possibility
politicamente	r	2	politically
pianificatore	n	2	planner
piazzare	v	2	place
pittoresco	a	2	picturesque
illustrato	a	2	pictorial
Philadelphia	n	2	philadelphia
Phase	n	2	phase
percussione	n	2	percussion
par	n	2	par
operistico	a	2	operatic
nazionalistico	a	2	nationalistic
muscoloso	a	2	muscular
Montreal	n	2	montreal
modernizzare	v	2	modernize
mancante	a	2	missing
Massachusetts	n	2	massachusetts
Corpo_della_Marina	n	2	marine_corps
manoscritto	n	2	manuscript
vicegovernatore	n	2	lieutenant_governor
colto	a	2	learned
pigro	a	2	lazy
ionizzato	a	2	ionized
integrante	a	2	integral
inibitore	a	2	inhibitory
idrofobo	a	2	hydrophobic
umiliante	a	2	humiliating
Houston	n	2	houston
scuola_media_superiore	n	2	high_school
ibernare	v	2	hibernate
ecco	r	2	here
Harlem	n	2	harlem
ginnastico	a	2	gymnastic
ginnico	a	2	gymnastic
guanto	n	2	glove
Gibson_Girl	n	2	gibson_girl
fullback	n	2	fullback
frustrato	a	2	frustrated
lungi	r	2	far
fairway	n	2	fairway
esteso	a	2	extensive
previsto	a	2	expected
ciascuno	a	2	every
ottanta	a	2	eighty
orientale	a	2	eastern
drammaticamente	r	2	dramatically
distintivo	a	2	distinctive
dissolvere	v	2	dispel
diminuito	a	2	diminished
vice	n	2	deputy
dentale	a	2	dental
deltoide	n	2	deltoid
tagliato	a	2	cut
sgualcito	a	2	crushed
grossolano	a	2	crude
cps	n	2	cps
convulsivo	a	2	convulsive
conservativo	a	2	conservative
riflesso_condizionato	n	2	conditioned_reflex
clubhouse	n	2	clubhouse
chiaro	r	2	clearly
rivendicazione	n	2	claim
cinematografico	a	2	cinematic
Padri_della_Chiesa	n	2	church_father
bodybuilders	n	2	bodybuilder
biologico	a	2	biological
piegato	a	2	bent
Bench_Press	n	2	bench_press
barbuto	a	2	bearded
auditorium	n	2	auditorium
presumere	v	2	assume
autorizzato	a	2	approved
apparente	a	2	apparent
analettico	a	2	analeptic
alkali_bee	n	2	alkali_bee
fungere	v	2	act_as
novello	a	1	young
yankee	a	1	yankee
miserabile	a	1	wretched
misero	a	1	wretched
aspirante	a	1	would-be
lavoratore	a	1	working
filo_elettrico	n	1	wire
winner	n	1	winner
ammiccare	v	1	wink
ventoso	a	1	windy
tortuoso	a	1	winding
aggiudicare	v	1	win
astuto	a	1	wily
volontà 	n	1	will
whisky-on-the-rocks	n	1	whisky_on_the_rocks
Weltanschauung	n	1	weltanschauung
colto	a	1	well-read
Ways	n	1	way
sprecato	a	1	wasted
diffidente	a	1	wary
votivo	a	1	votive
voodoo	n	1	voodoo
voluminoso	a	1	voluminous
vividamente	r	1	vividly
virtuale	a	1	virtual
verticale	a	1	vertical
primaverile	a	1	vernal
vellutato	a	1	velvety
venato	a	1	veined
venare	v	1	vein
svariato	a	1	various
variante	a	1	variant
svanito	a	1	vanished
vano	a	1	vain
usuale	a	1	usual
urgentemente	r	1	urgently
aggiornato	a	1	up-to-date
lassù	r	1	up
irremovibile	a	1	unshakable
invisibile	a	1	unseen
insensibile	a	1	unresponsive
esposto	a	1	unprotected
azzimo	n	1	unleavened_bread
universalistico	a	1	universalistic
unità 	n	1	unit
indenne	a	1	unimpaired
deplorevole	a	1	unfortunate
imbarazzato	a	1	uneasy
indesiderato	a	1	undesirable
subacqueo	a	1	underwater
subdolo	a	1	underhanded
sottosviluppato	a	1	underdeveloped
sotto	a	1	under
acritico	a	1	uncritical
inflessibile	a	1	uncompromising
contrarsi	v	1	twitch
contorcersi	v	1	twist
ventunesimo	a	1	twenty-first
Twenties	n	1	twenties
dodicesimo	a	1	twelfth
tornire	v	1	turn
turn	v	1	turn
Tudor	n	1	tudor
autotrasporto	n	1	trucking
vittorioso	a	1	triumphant
trigonale	a	1	trigonal
viaggiare	n	1	travel
arruffato	a	1	tousled
resistente	a	1	tough
toccarsi	v	1	touch
barcollante	a	1	tottering
totemico	a	1	totemic
total	n	1	total
tortuoso	a	1	tortuous
intorpidito	a	1	torpid
spazzolino	n	1	toothbrush
sincronizzazione	n	1	timing
piastrellato	a	1	tiled
allacciarsi	v	1	tie
ticchettare	v	1	tick
spingersi	v	1	thrust
fitto	a	1	thick
teatrale	a	1	theatrical
teutonico	a	1	teutonic
formidabile	a	1	terrific
teenagers	n	1	teenager
loquace	a	1	talky
assumersi	v	1	take
Taiwan	n	1	taiwan
tackle	n	1	tackle
sincronico	a	1	synchronous
comprensivo	a	1	sympathetic
simbolicamente	r	1	symbolically
simbolico	a	1	symbolic
sushi	n	1	sushi
superficiale	a	1	surface
supino	a	1	supine
superlativo	a	1	superlative
sovrapposto	a	1	superimposed
superficiale	a	1	superficial
super	a	1	super
assolato	a	1	sunny
incavato	a	1	sunken
sensuale	a	1	sultry
bastare	v	1	suffice
sofferente	a	1	suffering
subentrare	v	1	succeed
subordinato	a	1	subordinate
subdivision	n	1	subdivision
subconscio	a	1	subconscious
tempestato	a	1	studded
structure	n	1	structure
strike	n	1	strike
allungamento	n	1	stretch
strozzato	a	1	strangled
St._Petersburg	n	1	st._petersburg
cantastorie	n	1	storyteller
interrompersi	v	1	stop
St._Louis_Cardinals	n	1	st._louis
St._Louis	n	1	st._louis
stimuli	n	1	stimulus
artificioso	a	1	stilted
vischioso	a	1	sticky
attenersi	v	1	stick_to
stereofonico	a	1	stereophonic
stereo	a	1	stereo
stereofonia	n	1	stereo
cancelleria	n	1	stationery
incamminarsi	v	1	start
scanno	n	1	stall
acciaio_inossidabile	n	1	stainless_steel
macchiato	a	1	stained
stagnante	a	1	stagnant
stabilizzante	a	1	stabilizing
accovacciare	v	1	squat
squadrato	a	1	squared
quadrare	v	1	square
quadrato	a	1	square
sputnik	n	1	sputnik
sorgente	n	1	spring
spugnoso	a	1	spongy
viziato	a	1	spoiled
spinnability	n	1	spinnability
precisare	v	1	specify
specializzare	v	1	specialize
sfavillante	a	1	sparkling
spazioso	a	1	spacious
sudista	a	1	southern
fradicio	a	1	sopping
solo	n	1	solo
solitario	a	1	solitary
solenne	a	1	solemn
tenue	a	1	soft
sodium	n	1	sodium
sapone_in_scaglie	n	1	soap_flakes
comodamente	r	1	snugly
azzannare	v	1	snap
sorridente	a	1	smiling
schiantare	v	1	smash
smash	n	1	smash
pigro	a	1	sluggish
sbobba	n	1	slop
slice	n	1	slice
assonnato	a	1	sleepy
insonnolito	a	1	sleepy
schiaffeggiare	v	1	slap
spiovente	a	1	slanting
gracile	a	1	skinny
ubicazione	n	1	site
sinusoidale	a	1	sinusoidal
argenteo	a	1	silver
cortezza	n	1	shortness
radersi	v	1	shave
duramente	r	1	sharply
scaltro	a	1	sharp
spigoloso	a	1	sharp
informe	a	1	shapeless
scosso	a	1	shaken
svariato	a	1	several
scenografia	n	1	set
sensitivity	n	1	sensitivity
autosufficiente	a	1	self-sufficient
quartiere	n	1	section
Segretario_di_Stato	n	1	secretary_of_state
in_secondo_luogo	r	1	secondly
Seattle	n	1	seattle
scheletrico	a	1	scrawny
sparso	a	1	scattered
Savannah	n	1	savannah
campionare	v	1	sample
medesimo	a	1	same
scroscio	n	1	salvo
salino	a	1	salty
saloon	n	1	saloon
Sally	n	1	sally
campagnolo	a	1	rural
marcato	a	1	rugged
rudimentale	a	1	rudimentary
raduno	n	1	roundup
grezzo	a	1	rough
Rookie	n	1	rookie
ruotare	v	1	roll
ritualizzare	v	1	ritualize
legittimamente	r	1	rightfully
Richmond	n	1	richmond
Ribes_sanguineum	n	1	ribes_sanguineum
venerato	a	1	revered
restituire	v	1	return
pensionato	a	1	retired
risultante	a	1	resultant
restituire	v	1	restore
rifornire	v	1	restock
irrequieto	a	1	restless
irrequieto	a	1	restive
responsorio	n	1	response
rispettato	a	1	respected
dimettersi	v	1	resign
riproducibile	a	1	reproducible
repressivo	a	1	repressive
ripetuto	a	1	repeated
riluttante	a	1	reluctant
Regius_Professor	n	1	regius_professor
riformato	a	1	reformed
reflexly	r	1	reflexly
redimere	v	1	redeem
ricorrente	a	1	recurrent
rettangolare	a	1	rectangular
Recording	n	1	recording
riconciliare	v	1	reconcile
riconoscibile	a	1	recognizable
riaffermare	v	1	reassert
riaffermare	v	1	reaffirm
crudo	a	1	raw
razionale	a	1	rational
raduno	n	1	rally
rivangare	v	1	rake_up
rialzato	a	1	raised
sfolgorante	a	1	radiant
donchisciottesco	a	1	quixotic
lamentoso	a	1	querulous
pittoresco	a	1	quaint
mettersi	v	1	put
spingersi	v	1	push
Purple_Heart	n	1	purple_heart
punibile	a	1	punishable
pubblicato	a	1	published
pubblicizzare	v	1	publicize
sistema_tolemaico	n	1	ptolemaic_system
psicotico	a	1	psychotic
abilità 	n	1	prowess
provinciale	a	1	provincial
proprietà 	n	1	property
incline	a	1	prone
preminente	a	1	prominent
prominenza	n	1	prominence
professionistico	a	1	professional
primordiale	a	1	primitive
rudimentale	a	1	primitive
primordiale	a	1	primeval
presumere	v	1	presume
incalzante	a	1	pressing
prescritto	a	1	prescribed
power	n	1	power
grondare	v	1	pour
chiuso	n	1	pound
Postmaster_General	n	1	postmaster_general
postumo	a	1	posthumous
solenne	a	1	portentous
popolato	a	1	populous
popolato	a	1	populated
popolare	v	1	populate
misero	a	1	poor
prassi	n	1	policy
additare	v	1	point
commovente	a	1	poignant
toccante	a	1	poignant
compagno_di_giochi	n	1	playmate
disputare	v	1	play
play	n	1	play
platonico	a	1	platonic
localizzare	a	1	place
Pittsburgh	n	1	pittsburgh
Phoenix	n	1	phoenix
personalizzato	a	1	personalized
impertinente	a	1	perky
perire	v	1	perish
percettivo	a	1	perceptive
popolare	v	1	people
Pentagon	n	1	pentagon
rattoppato	a	1	patched
pastello	a	1	pastel
parroco	n	1	parson
parallela	n	1	parallel_bars
paradossale	a	1	paradoxical
cartaceo	a	1	papery
pannello	n	1	pane
pachinko	n	1	pachinko
proprietà 	n	1	ownership
strapiombo	n	1	overhang
antiquato	a	1	outmoded
uscente	a	1	outgoing
outfield	n	1	outfield
orientale	a	1	oriental
organizzarsi	v	1	organize
metodico	a	1	orderly
arancione	a	1	orange
ottimale	a	1	optimal
aperto	n	1	open
olimpionico	a	1	olympic
old	a	1	old
superato	a	1	old
Oklahoma	n	1	oklahoma
oleoso	a	1	oily
untuoso	a	1	oily
offrirsi	v	1	offer
Octave	n	1	octave
occipitale	a	1	occipital
osservabile	a	1	observable
osceno	a	1	obscene
ignaro	a	1	oblivious
neppure	r	1	not
nostalgico	a	1	nostalgic
Northland	n	1	northland
inesistente	a	1	nonexistent
nominare	n	1	nominate
Nomia_melanderi	n	1	nomia_melanderi
notturno	a	1	nocturnal
Nuovo_Testamento	n	1	new_testament
New_Mexico	n	1	new_mexico
New_Deal	n	1	new_deal
neonato	a	1	newborn
nidificare	v	1	nest
lampada_al_neon	n	1	neon_tube
marinaro	a	1	nautical
narrativo	a	1	narrative
naprapath	n	1	naprapath
naive	a	1	naive
inchiodare	v	1	nail
agguantare	v	1	nab
torbido	a	1	murky
attutito	a	1	muffled
imbacuccato	a	1	muffled
smorzato	a	1	muffled
montato	a	1	mounted
montuoso	a	1	mountainous
motorio	a	1	motor
altro	n	1	more
moon	n	1	moon
scandaloso	a	1	monstrous
monofonico	a	1	monophonic
monomero	n	1	monomer
money	n	1	money
moderatamente	r	1	moderately
modale	a	1	modal
finto	a	1	mock
misto	a	1	mixed
brumoso	a	1	misty
Missouri	n	1	missouri
perso	a	1	missing
Minneapolis	n	1	minneapolis
insensato	a	1	mindless
Milwaukee	n	1	milwaukee
metrazol	n	1	metrazol
metodico	a	1	methodical
mero	a	1	mere
membership	n	1	membership
melodrammatico	a	1	melodramatic
marketing	n	1	marketing
marcato	a	1	marked
Corpo_dei_Marine	n	1	marine_corps
marginalmente	r	1	marginally
mantrap	n	1	mantrap
maniacale	a	1	maniacal
Manhattan	n	1	manhattan
deforme	a	1	malformed
stipulare	v	1	make
maestoso	a	1	majestic
storpiato	a	1	maimed
magnetico	a	1	magnetic
furioso	a	1	mad
perduto	a	1	lost
Lorelei	n	1	lorelei
incombere	v	1	loom
somigliare	v	1	look_like
Long_Island	n	1	long_island
pagnotta	n	1	loaf
Liverpool	n	1	liverpool
letterato	a	1	literate
listare	v	1	list
rugoso	a	1	lined
Lincoln	n	1	lincoln
lilla	a	1	lilac
autorizzato	a	1	licensed
dissoluto	a	1	lewd
prestarsi	v	1	lend
contratto_di_locazione	n	1	lease
appoggiarsi	v	1	lean
preminente	a	1	leading
leaders	n	1	leaders
lanciamissili	n	1	launcher
allampanato	a	1	lanky
landler	n	1	landler
carente	a	1	lacking
inginocchiare	v	1	kneel
Kipling	n	1	kipling
mantenersi	v	1	keep
tenersi	v	1	keep
Kansas	n	1	kansas
giovanile	a	1	juvenile
congiunto	a	1	joint
Jazz_Festival	n	1	jazz_festival
Janissaries	n	1	janissary
frastagliato	a	1	jagged
ionico	a	1	ionic
invisibile	a	1	invisible
intimamente	r	1	intimately
interpretabile	a	1	interpretable
intermittente	a	1	intermittent
intensamente	r	1	intensely
programmato	a	1	intended
integrato	a	1	integrated
illeso	a	1	intact
intatto	a	1	intact
insufficiente	a	1	insufficient
inside_out	r	1	inside_out
inospitale	a	1	inhospitable
inflessibile	a	1	inflexible
immancabile	a	1	inevitable
rivoluzione_industriale	n	1	industrial_revolution
induced	v	1	induce
indignato	a	1	indignant
Indianapolis	n	1	indianapolis
infaticabile	a	1	indefatigable
incompleto	a	1	incomplete
incandescente	a	1	incandescent
incapacità 	n	1	inability
improvvisato	a	1	improvised
impotente	a	1	impotent
imperiale	a	1	imperial
immunità 	n	1	immunity
imminente	a	1	imminent
immenso	a	1	immense
Illinois	n	1	illinois
Ile_de_France	n	1	ile-de-france
ozioso	a	1	idle
idiota	a	1	idiotic
gelido	a	1	icy
idrato	a	1	hydrous
rauco	a	1	husky
capannello	n	1	huddle
h	n	1	hr
rovente	a	1	hot
terrificante	a	1	horrifying
orrido	a	1	horrid
Santo_Sacrificio	n	1	holy_sacrament
hole	n	1	hole
indire	n	1	hold
indire	v	1	hold
high	a	1	high
eredità 	n	1	heredity
impotente	a	1	helpless
colmare	v	1	heap
schiudersi	v	1	hatch
laborioso	a	1	hardworking
sodo	r	1	hard
Guy_Fawkes_Day	n	1	guy_fawkes_day
sempliciotto	a	1	gullible
agghiacciante	a	1	gruesome
grottesco	n	1	grotesque
brizzolato	a	1	grizzled
sorrisetto	n	1	grin
green	n	1	green
gravità 	n	1	gravity
accordato	a	1	granted
Venerdì_Santo	n	1	good_friday
andato	a	1	gone
risalire	v	1	go_back
abbandonarsi	v	1	give_way
volgere	v	1	get
George_Washington	n	1	george_washington
generatrice	n	1	generator
generalizzare	v	1	generalize
general	a	1	general
raduno	n	1	gathering
lampada_a_gas	n	1	gas_lamp
furtivo	a	1	furtive
scalpore	n	1	furor
furlongs	n	1	furlong
aggrottare	v	1	frown
amico	a	1	friendly
Freud	n	1	freud
focalizzare	v	1	focus
fluido	a	1	fluid
fluente	a	1	flowing
galleggiare	v	1	float
appariscente	a	1	flashy
svasatura	n	1	flare
adattarsi	v	1	fit
finitura	n	1	finishing
finitura	n	1	finish
rifinitura	n	1	finish
benissimo	r	1	fine
filmato	n	1	film
difendersi	v	1	fight_back
Federal_Housing_Administration	n	1	federal_housing_administration
fantasioso	a	1	fantastic
fans	n	1	fan
dissolvenza	n	1	fadeout
sbiadito	a	1	faded
scolorito	a	1	faded
atteso	a	1	expected
allargato	a	1	expanded
esotico	a	1	exotic
scambiarsi	v	1	exchange
eventuale	a	1	eventual
addirittura	r	1	even
neppure	r	1	even
preventivo	n	1	estimate
costituito	a	1	established
scappatella	n	1	escapade
uguagliare	v	1	equate
epigramma	n	1	epigram
trincerarsi	v	1	entrench
iscriversi	v	1	enter
enigmatico	a	1	enigmatic
impegnarsi	v	1	engage
commovente	a	1	emotional
emozionale	a	1	emotional
allungato	a	1	elongated
undicesimo	a	1	eleventh
elettricità 	n	1	electricity
egocentrico	a	1	egocentric
didattico	a	1	educational
didattica	n	1	education
editor	n	1	editor
agevole	a	1	easy
anticipato	a	1	early
desideroso	a	1	eager
resistente	a	1	durable
duplice	a	1	dual
ubriaco	n	1	drunk
siccità 	n	1	drought
mascherarsi	v	1	dress_up
discendente	a	1	downward
down	n	1	down
laggiù	r	1	down
bastare	v	1	do
compire	v	1	do
divino	n	1	divine
diviso	a	1	divided
stravolto	a	1	distraught
distante	a	1	distant
disservizio	n	1	disservice
squalificare	v	1	disqualify
squalificato	a	1	disqualified
disinteressato	a	1	disinterested
disintegrazione	n	1	disintegration
liberarsi	v	1	disengage
deludente	a	1	disappointing
direzionale	a	1	directional
direct	a	1	direct
diplomatico	a	1	diplomatic
minuto	a	1	diminutive
dignitario	n	1	dignitary
differenziale	a	1	differential
demoniaco	a	1	devilish
auspicabile	a	1	desirable
discendente	a	1	descending
Ministero_del_Lavoro	n	1	department_of_labor
Dipartimento_di_Agricoltura	n	1	department_of_agriculture
fitto	a	1	dense
confessionale	a	1	denominational
pudico	a	1	demure
fare	r	1	deliver
squisito	a	1	delicious
insufficiente	a	1	deficient
dichiarazione_di_guerra	n	1	declaration
determinante	a	1	decisive
decentralizzare	v	1	decentralize
caro	r	1	dearly
occuparsi	v	1	deal
caduto	a	1	dead
smagliante	a	1	dazzling
datato	a	1	dated
oscurità 	n	1	darkness
tenebroso	a	1	dark
screziato	a	1	dappled
minuto	a	1	dainty
curricula	n	1	curriculum
cagnaccio	n	1	cur
coppetta	n	1	cup
culminare	v	1	culminate
rudimentale	a	1	crude
accucciarsi	v	1	crouch
acquattare	v	1	crouch
incrociato	a	1	cross
sconquassato	a	1	cranky
cowboy	n	1	cowboy
schedina	n	1	coupon
cosec	n	1	cosecant
correlare	v	1	correlate
coquette	n	1	coquette
coordinato	a	1	coordinated
coordinato	a	1	coordinate
cooperare	v	1	cooperate
Cook	n	1	cook
convergere	v	1	converge
contiguo	a	1	contiguous
consultarsi	v	1	consult
conformarsi	v	1	conform_to
conformarsi	v	1	conform
confermazione	n	1	confirmation
confidenziale	a	1	confidential
confederato	a	1	confederate
condensato	a	1	condensed
simultaneo	a	1	concurrent
concertato	a	1	concerted
concettualizzazione	n	1	conceptualization
esauriente	a	1	comprehensive
questore	n	1	commissioner
commando	n	1	commando
comandamento	n	1	commandment
imbattere	v	1	come_across
provenire	v	1	come
incolore	a	1	colorless
coesivo	a	1	cohesive
coesistente	a	1	coexistent
clown	n	1	clown
approfondito	a	1	close
abbarbicarsi	v	1	cling_to
aggrappare	v	1	cling
geniale	a	1	clever
palese	a	1	clear
Clean	n	1	clean
amministrazione_pubblica	n	1	civil_service
civilizzazione	n	1	civilization
Città_di_Dio	n	1	city_of_god
città 	n	1	city
prescegliere	v	1	choose
cavalleresco	a	1	chivalrous
caritatevole	a	1	charitable
incaricare	v	1	charge
tariffa	n	1	charge
caratterizzazione	n	1	characterization
casuale	a	1	chance
Century	n	1	century
censimento	n	1	census
casual	a	1	casual
casuale	a	1	casual
candidatura	n	1	candidacy
Cambridge	n	1	cambridge
accaparrarsi	v	1	buy_up
trafficato	a	1	busy
galleggiante	a	1	buoyant
bunt	n	1	bunt
Bumblebees	n	1	bumblebee
voluminoso	a	1	bulky
bruto	a	1	brute
spazzolino	n	1	brush
spezzato	a	1	broken
Broadway	n	1	broadway
marcato	a	1	broad
apportare	v	1	bring
brillantemente	r	1	brilliantly
briefing	n	1	briefing
trasgredire	v	1	break
squillante	a	1	brassy
intrecciato	a	1	braided
rassegnarsi	v	1	bow
legato	a	1	bound
bouncing_betties	n	1	bouncing_betty
mutuatario	n	1	borrower
prenotato	a	1	booked
ossuto	a	1	bony
cappellino	n	1	bonnet
bodybuilding	n	1	bodybuilding
smussato	a	1	blunt
dissanguare	v	1	bleed
spoglio	a	1	bleak
Birmingham	n	1	birmingham
vincolante	a	1	binding
occhialuto	a	1	bespectacled
vantaggiare	v	1	benefit
bench	n	1	bench
belligerante	a	1	belligerent
tardivo	a	1	belated
muscoloso	a	1	beefy
provenire	v	1	be
spinto	a	1	bawdy
baronale	a	1	baronial
banker	n	1	banker
calvo	a	1	bald
assiomatico	a	1	axiomatic
award	n	1	award
atteso	a	1	awaited
ausiliare	a	1	auxiliary
asintotico	a	1	asymptotic
cinereo	a	1	ashen
ascendente	a	1	ascending
artificiale	a	1	artificial
Arkansas	n	1	arkansas
acquoso	a	1	aqueous
accostarsi	v	1	approach
applicato	a	1	applied
applicabilità 	n	1	applicability
distante	r	1	apart
anti	a	1	anti
anomia	n	1	anomie
anomic	a	1	anomic
angolare	a	1	angular
rabbioso	a	1	angry
ambivalente	a	1	ambivalent
ambiguità 	n	1	ambiguity
sbalordito	a	1	amazed
dilettantistico	a	1	amateur
alundum	n	1	alundum
alkylbenzenesulfonates	n	1	alkylbenzenesulfonate
Alabama	n	1	alabama
arieggiato	a	1	airy
agglomerare	v	1	agglomerate
agglomerarsi	v	1	agglomerate
postumo	n	1	aftereffect
avventurarsi	v	1	adventure
aderire	v	1	adhere
adattarsi	v	1	adapt
intensamente	r	1	acutely
attività 	n	1	activity
acrobatico	a	1	acrobatic
abituato	a	1	accustomed
accusatorio	a	1	accusing
accelerato	a	1	accelerated
absolute	a	1	absolute
Abe_Lincoln	n	1	abraham_lincoln
abbreviato	a	1	abbreviated
3_hitter	n	1	3-hitter
20th	a	1	20th
19th	a	1	19th
undef	r	11	
classificare	n	1	
dimenticare	n	1	
elaborare	n	1	
evitare	n	1	
io	v	1	
questo	r	1	
sopraffatto	v	1	
svolgimento	n	1	
televisivo	n	1	
