în_general	r	9	generally
de_fapt	r	9	actually
deja_vu	n	7	deja_vu
în_același_timp	r	7	at_the_same_time
de_asemenea	r	78	also
avea_nevoie	v	6	need
în_final	r	6	finally
corp_negru	n	6	blackbody
și_așa_mai_departe	r	6	and_so_on
fi_de_acord	v	6	agree
din_păcate	r	5	unfortunately
în_general	r	5	in_general
în_jos	r	5	down
de_asemenea	r	5	as_well
în_sus	r	4	up
fără_îndoială	r	4	undoubtedly
deget_de_la_picior	n	4	toe
punct_de_vedere	n	4	standpoint
vânzare_cu_amănuntul	n	4	retailing
energie_potențială	n	4	potential_energy
da_din_cap	v	4	nod
între_timp	r	4	meanwhile
pune_în_scenă	v	3	stage
radiație_solară	n	3	solar_radiation
pur_și_simplu	r	3	simply
doi	a	3	latter
stat_în_mâini	n	3	handstand
duzină	n	3	dozen
război_rece	n	3	cold_war
mic_dejun	n	3	breakfast
sârmă_ghimpată	n	3	barbed_wire
ivi	v	3	arise
albină_lucrătoare	n	2	worker_bee
în_sus	r	2	upwards
în_sus	r	2	upward
lua_parte	v	2	take_part
balansa	v	2	swing
temperatura_camerei	n	2	room_temperature
de_fapt	r	2	really
viață_reală	n	2	real_life
pictură_în_ulei	n	2	oil_painting
club_de_noapte	n	2	nightclub
cădere_nervoasă	n	2	nervous_breakdown
rezonanță_magnetică	n	2	magnetic_resonance
în_față	r	2	in_front
emisie_infraroșie	n	2	infrared_emission
ființă_umană	n	2	human_being
înaltă_fidelitate	n	2	high_fidelity
jucător_de_golf	n	2	golfer
din_fericire	r	2	fortunately
grădină_de_flori	n	2	flower_garden
la_fel_de	r	2	equally
definit	a	2	definite
reflex_condiționat	n	2	conditioned_reflex
cortex_cerebral	n	2	cerebral_cortex
arcui	v	2	arch
în_față	r	2	ahead
Statele_Unite	n	2	
Uniunea_Sovietică	n	2	
forță_de_muncă	n	1	work_force
zi_lucrătoare	n	1	weekday
ziua_nunții	n	1	wedding_day
vapori_de_apă	n	1	water_vapor
pierdere_de_timp	n	1	waste_of_time
sistem_de_votare	n	1	voting_system
punct_de_vedere	n	1	viewpoint
cerc_vicios	n	1	vicious_cycle
vice-președinte	n	1	vice_president
din_nefericire	r	1	unfortunately
în_final	r	1	ultimately
ultime	a	1	ultimate
treimi	n	1	two-thirds
douăzeci_și_unu	n	1	twenty-one
avea_încredere	v	1	trust
linie_de_tranzit	n	1	transit_line
face_comerț	v	1	trade
glandă_tiroidă	n	1	thyroid_gland
treimi	n	1	third
depune_mărturie	v	1	testify
zecimi	n	1	tenth
teren_de_tenis	n	1	tennis_court
avea_grijă	v	1	tend
apel_telefonic	n	1	telephone_call
serviciu_de_ceai	n	1	tea_service
avea_grijă	v	1	take_care
senzație_tactilă	n	1	tactual_sensation
tenis_de_masă	n	1	table_tennis
punct_mort	n	1	standstill
ieși_în_evidență	v	1	stand_out
undă_sonoră	n	1	sound_wave
control_social	n	1	social_control
șlap	n	1	slipper
șantier_naval	n	1	shipyard
act_sexual	n	1	sex_act
sistem_de_canalizare	n	1	sewage_system
simțul_umorului	n	1	sense_of_humor
în_secret	r	1	secretly
în_al_doilea_rând	r	1	secondly
doi	a	1	secondary
tabelă_de_marcaj	n	1	scoreboard
om_de_știință	n	1	scientist
science_fiction	n	1	science_fiction
oră_de_vârf	n	1	rush_hour
pe_drept_cuvânt	r	1	rightly
pleca_călare	v	1	ride_off
pleca_călare	v	1	ride_away
vânzător_cu_amănuntul	n	1	retailer
proprietate_imobiliară	n	1	real_property
undă_radio	n	1	radio_wave
în_principal	r	1	principally
pre-sezon	n	1	preseason
concurs_de_popularitate	n	1	popularity_contest
științe_politice	n	1	political_science
platformă_politică	n	1	political_platform
partid_politic	n	1	political_party
punct_de_vedere	n	1	point_of_view
loc_de_naștere	n	1	place_of_birth
pișa	v	1	piss
efect_piezoelectric	n	1	piezoelectric_effect
apel_telefonic	n	1	phone_call
instrument_de_percuție	n	1	percussive_instrument
joc_de_societate	n	1	party_game
acid_nucleic	n	1	nucleic_acid
non-ficțiune	n	1	nonfiction
cămașă_de_noapte	n	1	nightdress
lună_nouă	n	1	new_moon
nouă	a	1	new
fenomen_natural	n	1	natural_phenomenon
venit_național	n	1	national_income
compoziție_muzicală	n	1	musical_composition
distrofie_musculară	n	1	muscular_dystrophy
scleroză_multiplă	n	1	multiple_sclerosis
greșeală_de_calcul	n	1	miscalculation
maestru_de_ceremonii	n	1	master_of_ceremonies
lucru_manual	n	1	manual_labor
în_principal	r	1	mainly
câmp_magnetic	n	1	magnetic_field
de_asemenea	r	1	likewise
științele_vieții	n	1	life_science
număr_de_înmatriculare	n	1	license_number
facultate_de_drept	n	1	law_school
energie_cinetică	n	1	kinetic_energy
formație_de_jazz	n	1	jazz_group
face_cunoștință	v	1	introduce
în_final	r	1	in_the_end
în_sfârșit	r	1	in_the_end
combustie_internă	n	1	internal_combustion
în_secret	r	1	in_secret
revoluție_industrială	n	1	industrial_revolution
parc_industrial	n	1	industrial_park
în_avans	r	1	in_advance
durere_de_cap	n	1	headache
jumătate_de_oră	n	1	half-hour
foiță_de_aur	n	1	gold_leaf
director_general	n	1	general_manager
lampă_cu_gaz	n	1	gas_lamp
din_când_în_când	r	1	from_time_to_time
la_nesfârșit	r	1	forever
notă_de_subsol	n	1	footnote
barcă_de_pescuit	n	1	fishing_boat
daună	a	1	first
primă	a	1	first
în_sfârșit	r	1	finally
avea_chef	v	1	feel_like
guvern_federal	n	1	federal_government
secretar_executiv	n	1	executive_secretary
da_naștere	v	1	engender
pune_capăt	v	1	end
îmbarca	v	1	embark
scaun_electric	n	1	electric_chair
șoc_electric	n	1	electrical_shock
ordin_de_plată	n	1	draft
în_jos	r	1	downward
lumina_zilei	n	1	daylight
școală_de_dans	n	1	dancing_school
fi_de_acord	v	1	concur
ceașcă_de_cafea	n	1	coffee_cup
în_principal	r	1	chiefly
muzică_de_cameră	n	1	chamber_music
cu_siguranță	r	1	certainly
corp_ceresc	n	1	celestial_body
în_general	r	1	by_and_large
linie_de_autobuz	n	1	bus_line
om_de_afaceri	n	1	businessman
parte_a_corpului	n	1	body_part
costum_de_baie	n	1	bathing_suit
în_spate	r	1	back
bombă_atomică	n	1	atomic_bomb
în_esență	r	1	at_heart
în_jur	r	1	around
din_nou	r	1	anew
aventura	v	1	adventure
de_asemenea	r	18	too
chiar_și	r	15	even
lungime_de_undă	n	12	wavelength
design_interior	n	11	interior_design
New_Deal	n	1	
Vinerea_Mare	n	1	
